W P P W P E W
W P W P P P W
P P W W P P W
P W P P P W W
P P P W W W W
W P W W W W W
P P W W W W W